11111111111111111111111111111
1P000000000000000C000000E0001
10000000000000000000000000001
10000000C0C000000000000010001
10000000C0C000000000000010001
10000000C0C000000000000010001
10000000000000000000000000001
10000000C0C000000000000010001
10000000C0C000000000000010001
10000000C0C000000000000010001
10000000000000000000000000001
10000000C0C000000000000010001
10000000C0C000000000000010001
10000000C0C000000000000010001
11111111111111111111111111111
