1111111111111111111
1P00000C00000000001
1000000000000000001
100C000C00000000001
1000000000000C00001
100C000000C00000001
100C000000C00011111
100C000000C00010001
1000000000E00010001
1111111111111111111
