11111111111111111111111111111
1P000000000000000C000000E0001
11111111111111111111111111111
