1111111111111111111
1000000C00000000001
1000000000000000001
100C000C00000000001
1000000000000000001
100C000P00C00000001
100C000E00C00011111
101C000000C00010C01
1001000000000000001
1111111111111111111
