11111111111111111111
100000P0C0000000C001
1000000C00000C0000C1
1E00000C00000C0000C1
11111111111111111111