1111111111111111111111111111111111111111111111111111111111111111111111111111111
11111111111111111111111111PCCC000000000E111111111111111111111111111111111111111
1111111111111111111111111111111111111111111111111111111111111111111111111111111