1111111111111111111
1P00E00C00000000001
1111111111111111111
